######################################################################################################################################################
######################################################################################################################################################
######################################################################################################################################################
######################################################################################################################################################
######################################################################################################################################################
######################################################################################################################################################
######################################################################################################################################################
######################################################################################################################################################
######################################################################################################################################################
######################################################################################################################################################
######################################################################################################################################################
######################################################################################################################################################
######################################################################################################################################################
######################################################################################################################################################
######################################################################################################################################################
######################################################################################################################################################
######################################################################################################################################################
######################################################################################################################################################
######################################################################################################################################################
######################################################################################################################################################
######################################################################################################################################################
######################################################################################################################################################
######################################################################################################################################################
######################################################################################################################################################
######################################################################################################################################################
######################################################################################################################################################
######################################################################################################################################################
######################################################################################################################################################
######################################################################################################################################################
######################################################################################################################################################
######################################################################################################################################################
######################################################################################################################################################
######################################################################################################################################################
######################################################################################################################################################
######################################################################################################################################################
######################################################################################################################################################
######################################################################################################################################################
######################################################################################################################################################
######################################################################################################################################################
######################################################################################################################################################
######################################################################################################################################################
######################################################################################################################################################
######################################################################################################################################################
######################################################################################################################################################
######################################################################################################################################################
######################################################################################################################################################
######################################################################################################################################################
######################################################################################################################################################
######################################################################################################################################################
######################################################################################################################################################
######################################################################################################################################################
###################################################................................................###################################################
###################################################................................................###################################################
###################################################................................................###################################################
###################################################................................................###################################################
###################################################................................................###################################################
###################################################................................................###################################################
###################################################................................................###################################################
###################################################................................................###################################################
###################################################................................................###################################################
###################################################................................................###################################################
###################################################................................................###################################################
###################################################................................................###################################################
###################################################................................................###################################################
###################################################................................................###################################################
###################################################................................................###################################################
###################################################................................................###################################################
###################################################................................................###################################################
###################################################................................................###################################################
###################################################................................................###################################################
###################################################................................................###################################################
###################################################................................................###################################################
###################################################................................................###################################################
###################################################................................................###################################################
###################################################................................................###################################################
###################################################................................................###################################################
###################################################................................................###################################################
###################################################................................................###################################################
###################################################................................................###################################################
###################################################................................................###################################################
###################################################................................................###################################################
###################################################................................................###################################################
###################################################................................................###################################################
###################################################................................................###################################################
###################################################................................................###################################################
###################################################................................................###################################################
###################################################................................................###################################################
###################################################................................................###################################################
###################################################................................................###################################################
###################################################................................................###################################################
###################################################................................................###################################################
###################################################................................................###################################################
###################################################................................................###################################################
###################################################................................................###################################################
###################################################................................................###################################################
###################################################................................................###################################################
###################################################................................................###################################################
###################################################................................................###################################################
###################################################........................==============..........###################################################
###########################################################################===============############################################################
###########################################################################===============############################################################
#######################################################################################===############################################################
#######################################################################################===############################################################
#######################################################################################===############################################################
#######################################################################################===############################################################
#######################################################################################===############################################################
#######################################################################################===############################################################
#######################################################################################===############################################################
#######################################################################################===############################################################
#######################################################################################===############################################################
#######################################################################################===############################################################
#######################################################################################===############################################################
#######################################################################################===############################################################
#######################################################################################===############################################################
#######################################################################################===############################################################
#######################################################################################===############################################################
#######################################################################################===############################################################
#######################################################################################===############################################################
##################################################################################OOOOO===OOOOO#######################################################
##################################################################################OOOOO===OOOOO#######################################################
##################################################################################OOOOO===OOOOO#######################################################
##################################################################################OOOOO===OOOOO#######################################################
##################################################################################OOOOO===OOOOO#######################################################
##################################################################################OOOOO====OOOO#######################################################
#######################################################OOOOOOOOOOOOOOOOO##########OOOOO=====OOO#######################################################
#######################################################OOOOOOOOOOOOOOOOO##########OOOOOO====OOO#######################################################
#######################################################OOOOOOOOOOOOOOOOO##########OOOOOOO===OOO#######################################################
#######################################################OOOOOOOOOOOOOOOOO##########OOOOOOO===OOO#######################################################
#######################################################OOOOOOOOOOOOOOOOO##########OOOOOOO===OOO#######################################################
#######################################################OOOOOOOOOOOOOOOOO##########OOOOOOO===OOO#######################################################
#######################################################OOOOOOOOOOOOOOOOO#################===##########################################################
#######################################################OOOOOOOOOOOOOOOOO##########OOOOOOO===OOOOOOO###################################################
#######################################################OOOOOOOOOOOOOOOOO##########OOOOOOO===OOOOOOO###################################################
#######################################################OOOOOOOO=============================OOOOOOO###################################################
#######################################################OOOOOOOO=============================OOOOOOO###################################################
#######################################################OOOOOOOO=============================OOOOOOO###################################################
#######################################################OOOOOOOOOOOOOOOOO##########OOOOOOO===OOOOOOO###################################################
#######################################################OOOOOOOOOOOOOOOOO##########OOOOOOO===OOOOOOO###################################################
#######################################################OOOOOOOOOOOOOOOOO##########OOOOOOO===OOOOOOO###################################################
#######################################################OOOOOOOOOOOOOOOOO##########OOOOOOOOOOOOOOOOO###################################################
#######################################################OOOOOOOOOOOOOOOOO##########OOOOOOOOOOOOOOOOO###################################################
#######################################################OOOOOOOOOOOOOOOOO##########OOOOOOOOOOOOOOOOO###################################################
#######################################################OOOOOOOOOOOOOOOOO##########OOOOOOOOOOOOOOOOO###################################################
#######################################################OOOOOOOOOOOOOOOOO##########OOOOOOOOOOOOOOOOO###################################################
##################################################################################OOOOOOOOOOOOOOOOO###################################################
##################################################################################OOOOOOOOOOOOOOOOO###################################################
######################################################################################################################################################
######################################################################################################################################################
######################################################################################################################################################
######################################################################################################################################################
